wwwwwwwwwwwwwwwwwwwwwwwwww
w-A----------------------w
w-------w---w--w-----w---w
w-------w---w--w-----w---w
w-------w---w--w-----w---w
w-----------w------------w
wwwww-wwwwwwwwwwww-wwwwwww
w-----------w------------w
w--w----w---w--w---------w
w--w----w---w--w------e--w
w--w----w---w--w--wwwww--w
w------------------------w
wwwwwwwwwwwwwwwwwwwwwwwwww 
